"be" = (/obj/effect/turf_decal/tile/neutral{dir = 1},/obj/effect/turf_decal/tile/neutral{dir = 8},/obj/effect/turf_decal/tile/neutral{dir = 4},/obj/effect/decal/cleanable/dirt,/obj/machinery/light/small{dir = 8},/turf/open/floor/plasteel/dark,/area/space)
"bD" = (/obj/effect/turf_decal/tile/neutral{dir = 4},/obj/effect/turf_decal/tile/neutral{dir = 1},/obj/effect/turf_decal/tile/neutral,/obj/effect/decal/cleanable/dirt,/obj/effect/decal/cleanable/cobweb/cobweb2,/turf/open/floor/plasteel/dark,/area/space)
"dn" = (/obj/effect/turf_decal/tile/blue{dir = 1},/obj/effect/turf_decal/tile/blue{dir = 4},/obj/effect/turf_decal/tile/blue,/obj/structure/table,/obj/machinery/recharger{pixel_y = 4},/obj/effect/decal/cleanable/dirt,/obj/effect/decal/cleanable/cobweb/cobweb2,/turf/open/floor/plasteel/dark,/area/space)
"dQ" = (/obj/effect/turf_decal/tile/neutral,/obj/effect/turf_decal/tile/neutral{dir = 8},/obj/effect/turf_decal/tile/neutral{dir = 1},/obj/effect/decal/cleanable/dirt,/obj/machinery/light/small{dir = 8},/turf/open/floor/plasteel/dark,/area/space)
"eb" = (/obj/machinery/door/airlock/command/glass{name = "Cockpit"; req_access_txt = "19"},/obj/effect/turf_decal/stripes/line{dir = 2},/obj/machinery/door/firedoor/border_only,/obj/machinery/door/firedoor/border_only{dir = 1},/obj/effect/decal/cleanable/dirt,/turf/open/floor/plasteel/dark,/area/space)
"el" = (/obj/effect/turf_decal/tile/blue{dir = 4},/obj/effect/turf_decal/tile/blue{dir = 1},/obj/effect/turf_decal/tile/blue{dir = 8},/obj/effect/decal/cleanable/dirt,/obj/structure/bed/roller,/obj/machinery/iv_drip,/obj/machinery/light/small{dir = 8},/turf/open/floor/plasteel/dark,/area/space)
"fs" = (/obj/effect/turf_decal/tile/neutral{dir = 1},/obj/effect/turf_decal/tile/neutral{dir = 8},/obj/effect/decal/cleanable/dirt,/turf/open/floor/plasteel/dark,/area/space)
"hw" = (/obj/effect/turf_decal/tile/neutral,/obj/effect/turf_decal/tile/neutral{dir = 8},/obj/effect/decal/cleanable/dirt,/turf/open/floor/plasteel/dark,/area/space)
"hP" = (/obj/effect/turf_decal/tile/neutral{dir = 1},/obj/effect/turf_decal/tile/neutral{dir = 8},/obj/effect/decal/cleanable/dirt,/obj/machinery/light/small{dir = 8},/turf/open/floor/plasteel/dark,/area/space)
"hQ" = (/obj/effect/decal/cleanable/dirt,/obj/structure/window/reinforced{dir = 4},/obj/structure/table/reinforced,/obj/structure/window/reinforced{dir = 1},/obj/item/storage/firstaid,/obj/item/crowbar,/turf/open/floor/plasteel/dark,/area/space)
"iI" = (/turf/template_noop,/area/template_noop)
"iW" = (/obj/effect/turf_decal/tile/red{dir = 4},/obj/effect/turf_decal/tile/red,/obj/effect/decal/cleanable/dirt,/turf/open/floor/plasteel/dark,/area/space)
"jt" = (/obj/effect/turf_decal/tile/red,/obj/effect/turf_decal/tile/red{dir = 8},/obj/effect/turf_decal/tile/red{dir = 1},/obj/effect/decal/cleanable/dirt,/obj/structure/table,/obj/item/storage/lockbox/loyalty,/obj/machinery/light/small{dir = 8},/turf/open/floor/plasteel/dark,/area/space)
"kn" = (/obj/effect/turf_decal/tile/blue{dir = 1},/obj/effect/turf_decal/tile/blue{dir = 8},/obj/effect/turf_decal/tile/blue{dir = 4},/obj/structure/table,/obj/item/storage/firstaid,/obj/item/crowbar,/obj/effect/decal/cleanable/dirt,/turf/open/floor/plasteel/dark,/area/space)
"mi" = (/obj/effect/turf_decal/tile/red,/obj/effect/turf_decal/tile/red{dir = 8},/obj/effect/turf_decal/tile/red{dir = 4},/obj/effect/decal/cleanable/dirt,/obj/structure/table,/obj/item/book/manual/wiki/security_space_law,/obj/machinery/light/small{dir = 4},/turf/open/floor/plasteel/dark,/area/space)
"mv" = (/turf/closed/wall/mineral/plastitanium,/area/space)
"mz" = (/turf/closed/wall/mineral/titanium,/area/space)
"oq" = (/obj/effect/decal/cleanable/dirt,/obj/structure/chair/comfy/shuttle{dir = 8},/obj/structure/window/reinforced{dir = 4},/obj/effect/turf_decal/bot,/turf/open/floor/plasteel/dark,/area/space)
"oz" = (/obj/effect/spawner/structure/window/shuttle,/obj/machinery/door/firedoor/window,/turf/open/floor/plating,/area/space)
"qO" = (/obj/structure/shuttle/engine/heater,/obj/structure/window/reinforced{dir = 1; layer = 2.9},/turf/open/floor/plating,/area/space)
"sE" = (/obj/effect/turf_decal/tile/blue,/obj/effect/turf_decal/tile/blue{dir = 8},/obj/effect/turf_decal/tile/blue{dir = 1},/obj/effect/decal/cleanable/dirt,/obj/machinery/light/small{dir = 8},/turf/open/floor/plasteel/dark,/area/space)
"uU" = (/obj/effect/decal/cleanable/dirt,/obj/structure/window/reinforced{dir = 4},/obj/structure/table/reinforced,/obj/structure/window/reinforced,/obj/item/toy/plush/beeplushie,/turf/open/floor/plasteel/dark,/area/space)
"va" = (/obj/effect/turf_decal/tile/neutral,/obj/effect/turf_decal/tile/neutral{dir = 4},/obj/effect/decal/cleanable/dirt,/turf/open/floor/plasteel/dark,/area/space)
"vi" = (/obj/effect/decal/cleanable/dirt,/obj/structure/chair/comfy/shuttle{dir = 4},/obj/structure/window/reinforced{dir = 8},/obj/effect/turf_decal/bot,/turf/open/floor/plasteel/dark,/area/space)
"vl" = (/obj/effect/turf_decal/tile/blue,/obj/effect/turf_decal/tile/blue{dir = 8},/obj/structure/chair/comfy/shuttle{dir = 1},/obj/effect/decal/cleanable/dirt,/turf/open/floor/plasteel/dark,/area/space)
"xI" = (/obj/effect/decal/cleanable/dirt,/obj/effect/decal/cleanable/blood/old,/turf/open/floor/plasteel/dark,/area/space)
"zz" = (/obj/effect/decal/cleanable/dirt,/obj/structure/table/reinforced,/obj/structure/window/reinforced{dir = 8},/obj/structure/window/reinforced,/obj/item/toy/plush/carpplushie,/turf/open/floor/plasteel/dark,/area/space)
"Am" = (/obj/machinery/door/airlock/titanium{name = "Emergency Shuttle Airlock"},/obj/structure/fans/tiny,/obj/docking_port/mobile/emergency{dir = 8; dwidth = 11; height = 10; name = "OrbitalStation emergency shuttle"; port_direction = 4; width = 16},/turf/open/floor/plating,/area/space)
"AL" = (/obj/effect/turf_decal/tile/blue,/obj/effect/turf_decal/tile/blue{dir = 4},/obj/effect/turf_decal/tile/blue{dir = 1},/obj/effect/decal/cleanable/dirt,/obj/machinery/stasis,/obj/effect/decal/cleanable/cobweb/cobweb2,/obj/machinery/light/small{dir = 4},/turf/open/floor/plasteel/dark,/area/space)
"Bh" = (/obj/effect/turf_decal/tile/blue,/obj/effect/turf_decal/tile/blue{dir = 4},/obj/effect/turf_decal/tile/blue{dir = 8},/obj/effect/decal/cleanable/dirt,/obj/machinery/stasis,/obj/machinery/light/small{dir = 4},/turf/open/floor/plasteel/dark,/area/space)
"Cb" = (/obj/effect/turf_decal/tile/neutral,/obj/effect/turf_decal/tile/neutral{dir = 4},/obj/effect/decal/cleanable/dirt,/obj/machinery/vending/wallmed{name = "Emergency NanoMed"; pixel_x = 26; use_power = 0},/obj/machinery/light/small{dir = 4},/turf/open/floor/plasteel/dark,/area/space)
"DZ" = (/obj/effect/turf_decal/tile/blue{dir = 8},/obj/effect/turf_decal/tile/blue,/obj/effect/decal/cleanable/dirt,/obj/machinery/computer/operating{dir = 1; name = "Robotics Operating Computer"},/turf/open/floor/plasteel/dark,/area/space)
"GF" = (/obj/effect/turf_decal/tile/blue,/obj/effect/turf_decal/tile/blue{dir = 8},/obj/effect/turf_decal/tile/blue{dir = 4},/obj/effect/decal/cleanable/dirt,/obj/machinery/light/small{dir = 4},/turf/open/floor/plasteel/dark,/area/space)
"GH" = (/obj/effect/turf_decal/tile/blue,/obj/effect/turf_decal/tile/blue{dir = 8},/obj/effect/decal/cleanable/dirt,/turf/open/floor/plasteel/dark,/area/space)
"GY" = (/obj/effect/turf_decal/tile/blue,/obj/effect/turf_decal/tile/blue{dir = 4},/obj/effect/decal/cleanable/dirt,/obj/machinery/vending/wallmed{name = "Emergency NanoMed"; pixel_x = 32; use_power = 0},/turf/open/floor/plasteel/dark,/area/space)
"Hf" = (/obj/effect/turf_decal/tile/red{dir = 8},/obj/effect/turf_decal/tile/red{dir = 1},/obj/effect/decal/cleanable/dirt,/obj/structure/chair/comfy/shuttle{dir = 4},/turf/open/floor/plasteel/dark,/area/space)
"HO" = (/obj/effect/turf_decal/tile/neutral,/obj/effect/turf_decal/tile/neutral{dir = 8},/obj/effect/turf_decal/tile/neutral{dir = 4},/obj/effect/decal/cleanable/dirt,/turf/open/floor/plasteel/dark,/area/space)
"IJ" = (/obj/structure/shuttle/engine/propulsion,/turf/open/space/basic,/area/space)
"IR" = (/obj/effect/turf_decal/tile/red{dir = 1},/obj/effect/turf_decal/tile/red{dir = 4},/obj/effect/turf_decal/tile/red,/obj/effect/decal/cleanable/dirt,/obj/structure/table,/obj/effect/decal/cleanable/cobweb/cobweb2,/obj/machinery/recharger,/obj/machinery/light/small{dir = 4},/turf/open/floor/plasteel/dark,/area/space)
"Lz" = (/obj/effect/turf_decal/tile/blue{dir = 1},/obj/effect/turf_decal/tile/blue{dir = 8},/obj/effect/turf_decal/tile/blue,/obj/effect/decal/cleanable/dirt,/obj/structure/bed/roller,/obj/machinery/iv_drip,/obj/machinery/light/small{dir = 8},/turf/open/floor/plasteel/dark,/area/space)
"LM" = (/obj/effect/turf_decal/tile/red,/obj/effect/turf_decal/tile/red{dir = 8},/obj/effect/decal/cleanable/dirt,/obj/structure/chair/comfy/shuttle{dir = 1},/turf/open/floor/plasteel/dark,/area/space)
"Mn" = (/obj/effect/turf_decal/tile/blue{dir = 1},/obj/effect/turf_decal/tile/blue{dir = 4},/obj/machinery/computer/emergency_shuttle,/obj/effect/decal/cleanable/dirt,/turf/open/floor/plasteel/dark,/area/space)
"MH" = (/obj/effect/turf_decal/tile/blue{dir = 1},/obj/effect/turf_decal/tile/blue{dir = 4},/obj/machinery/computer/crew,/obj/effect/decal/cleanable/dirt,/turf/open/floor/plasteel/dark,/area/space)
"PS" = (/obj/effect/turf_decal/tile/blue{dir = 1},/obj/effect/turf_decal/tile/blue{dir = 8},/obj/effect/decal/cleanable/dirt,/turf/open/floor/plasteel/dark,/area/space)
"PW" = (/obj/effect/turf_decal/tile/blue{dir = 1},/obj/effect/turf_decal/tile/blue{dir = 8},/obj/effect/decal/cleanable/dirt,/obj/structure/table/reinforced,/obj/structure/window/reinforced,/obj/structure/window/reinforced{dir = 1},/obj/item/storage/firstaid/regular{empty = 1; name = "First-Aid (empty)"},/obj/item/storage/firstaid/o2{pixel_x = 3; pixel_y = 3},/obj/item/storage/firstaid/fire{pixel_x = 6; pixel_y = 6},/obj/item/storage/firstaid/toxin{pixel_x = -4; pixel_y = 3},/obj/item/storage/backpack/duffelbag/med/surgery,/turf/open/floor/plasteel/dark,/area/space)
"Qt" = (/obj/effect/turf_decal/tile/blue{dir = 1},/obj/effect/turf_decal/tile/blue{dir = 4},/obj/machinery/computer/communications,/obj/effect/decal/cleanable/dirt,/turf/open/floor/plasteel/dark,/area/space)
"Qv" = (/obj/effect/turf_decal/tile/blue,/obj/effect/turf_decal/tile/blue{dir = 4},/obj/effect/decal/cleanable/dirt,/turf/open/floor/plasteel/dark,/area/space)
"UJ" = (/obj/effect/turf_decal/tile/blue{dir = 4},/obj/effect/turf_decal/tile/blue{dir = 1},/obj/effect/decal/cleanable/dirt,/obj/machinery/computer/operating,/turf/open/floor/plasteel/dark,/area/space)
"UZ" = (/obj/machinery/door/airlock/public/glass{name = "Emergency Shuttle Infirmary"},/obj/effect/decal/cleanable/dirt,/turf/open/floor/plasteel/dark,/area/space)
"VQ" = (/obj/effect/turf_decal/tile/neutral{dir = 4},/obj/effect/turf_decal/tile/neutral{dir = 1},/obj/effect/decal/cleanable/dirt,/turf/open/floor/plasteel/dark,/area/space)
"Ws" = (/obj/effect/turf_decal/tile/red{dir = 8},/obj/effect/turf_decal/tile/red{dir = 1},/obj/effect/turf_decal/tile/red{dir = 4},/obj/effect/decal/cleanable/dirt,/obj/structure/table,/obj/item/storage/box/handcuffs{pixel_x = 1; pixel_y = 3},/obj/machinery/light/small{dir = 8},/turf/open/floor/plasteel/dark,/area/space)
"Xp" = (/obj/machinery/door/airlock/public/glass{name = "Emergency Shuttle Brig"; req_access_txt = "2"},/obj/machinery/door/firedoor/border_only{dir = 4},/obj/machinery/door/firedoor/border_only{dir = 8},/obj/effect/decal/cleanable/dirt,/turf/open/floor/plasteel/dark,/area/space)
"Xq" = (/obj/effect/turf_decal/tile/red{dir = 1},/obj/effect/turf_decal/tile/red{dir = 4},/obj/effect/decal/cleanable/dirt,/obj/structure/chair/comfy/shuttle,/turf/open/floor/plasteel/dark,/area/space)
"XJ" = (/obj/effect/decal/cleanable/dirt,/turf/open/floor/plasteel/dark,/area/space)
"YI" = (/turf/template_noop,/area/space)
"Zv" = (/obj/effect/decal/cleanable/dirt,/obj/structure/table/reinforced,/obj/structure/window/reinforced{dir = 8},/obj/structure/window/reinforced{dir = 1},/obj/item/storage/firstaid,/obj/item/crowbar,/turf/open/floor/plasteel/dark,/area/space)

(1,1,1) = {"
iImzozozozozozozmzYI
mzmzknMHQtMnMHdnmzmz
mzmzsEGHvlvlGHGFmzmz
mzmzmzmzmzmzebebmzmz
mzelUJALmzbeVQVQbDAm
ozPSXJGYmzfshQZvCbmz
mzPWxIQvUZfsoqvivaoz
ozPSXJGYmzfsoqvivaoz
mzLzDZBhmzfsoqvivaoz
mzmzmzmzmzhPoqvivaoz
mzWsXqIRmzfsoqvivaoz
ozHfXJiWXpfsoqvivaoz
ozHfxIiWXpfsuUzzCbmz
mzjtLMmimzdQhwhwHOmz
mzqOqOqOqOqOqOqOqOmz
mvIJIJIJIJIJIJIJIJmv
"}
